0000000000000011111000001111110000000111
0000000000000011111000001111110000000111
0000000000000001000000000000000000000111
0000000000000001000000000000000000000111
0000000000000000000000000000000000000111
0000000000000000000000000000000001111111
0000000000000000000000000000000001111111
0000000000000000000100000100000001111111
0000000000000000000100000100000000011111
0000000000000000011100000111000000011111
0000000000000000010000000111000000000111
0010000000000000110000000111110000000111
0010000000000000000000000111110000000111
0010111000000000000000011111110000000111
0010111000000000000000001111110000000111
0010111111111000000000001111110000011111
0010111111111000000000001111110000011111
0010111111111110000000001111111111111111
0010111111111110000000001111111111111111
0010111111111111100000111111111111111111
0010111111111111111111111111111111111111
0010111111111111111111111111111111111111
0010111111111111111111111111111111111111
0010111111111111111111111111111111111111

